24
32
XXXXXXXXXXXXXXXXXXXXXXXXXXXXXXXX
X XXXX           XXX XXXXX XXX X
X XX   XXX XXXXX               X
X XX X XXXXXXXXXXXXXXXXXXXXXXX X
X XX X XXX                 XXX X
X XX X XXX XXXXXXXXXXXXXXX XXX X
X XX X XXX XXXXXXXXXXXX    XXX X
X      XXX XX        XX XXXXXX X
X XXXXXXXX XX XXXXXX XX        X
X X        XX X X XX XXXXXXXXXXX
X X XXXXXX XX X X XX XXXXXXXXXXX
X X      X XXS    XX           X
X X XX X X XXXXXXXXXXXXXXXXXXX X
X X XXXX X XXXXXXXXX           X
X X      X          X X X X X  X
X XXXXX XXXXXXXXXXX  X X X X X X
X     X                        X
X XXX XXXXXXXXXXXXXXXXXXXXXXXXXX
X                              X
XXXXXXXXXX XX X X X XXX XXXXXX X
X             XXXXXX         X X
XXXXX XXXXXXXXX     XXXXXXXX X X
XX              XXX       X    X
XXXXXXXXXXXXXXXXXXXXXXXXXFXXXXXX